111111111111111111
1P0000000001000001
100011000001011001
1000C1000010C10001
111011000001111001
1000C1000100000001
110011000001000001
100000000001111111
1111110000100000C1
1E0001000010000001
100000000001000001
10000C000000000001
100000000001000001
111111111111111111
